6 6
0 0 A 0 0 0
0 R 0 0 0 B
0 0 0 0 0 0
E 0 0 0 0 0
0 0 0 0 C 0
0 D 0 0 0 0